...................................................................................................................................
....#...........#.#.#.....#..##.........##............##.#............#.......#.........##........#.#............##..#.....#....##.
..#.........#....#.#........#.#.........#........##.#...#...........................##..#......#....#....#...#.#..#...#.#.#........
...###....#......#...........#.##...#.................#....................###.........#.#........#...........#..#.....#........#..
.##..##...##....#.......#..........#.......#.................................#..##.....##......#........#.....##........#..........
....#..........##..#...###.#.......#.......#.#.........#....................#..#..#...........................##...................
......#...#..#...#................................#..#...................................#.#...#..#...........#................#...
...#........#.......##....#....#..#..#.......#......................#.......#................###.........#............#.........#..
...........#.#..#....#.#.#..........##....#####.....##.........#..#.#.........#..........#..###..#.#...###.........#........##.#...
..........#.....#.........#....#.....#..#.#.................##..#................#..................#.##..............##....#..#...
............##.#.#....#.#...................................#..#...#.##.........#.................##..#........#....#...........#..
..........#..............##...#............#....##..................#..............................#.##..#........#..##...#........
......#..#...#..#.....##..#..#...........#..#.#..#............#.......#..#..........#................#...#.#..#..#..............##.
.......##....#........#.......#....#........##..#........#.....#..#.....#.............................................##.........#.
.................#...#..........#..#....#...................#..#....##.#........................##...#.......##...........#..#...#.
.....#......#...............................#..........#.##................#............#....#..........#.....#..#............#....
................#....#....#.........#.#..................#.....#...........................................#....#...........#......
....##.....##......#.##....#........##...#................#....................................#.#......#..#.....##............#...
.#..#.......#.#...........#..........................#........#.........#....#...............#..#..#..#.....#..#...#..#..##...#....
................##.#.##...............#.#..........##.........#...........#....................#....#..................##..........
..................#..#.....#...........................................##...#.#...............#..#..#.......###...#......#..#...#..
.....##..#...#......#......#....#...................##...##....##......##.#.#.............#..............##....##...........#......
..#......#...#..........#..#......####................#............#..........#.................#...........#....#..##..#...###..#.
.....#.......#...#......#......#.##...................#...#....#................#.#.#.........#..#...#.....#..##....#.........#....
.#..#.#..##............#.....#..........................#.#...#.#...#........#....#...........#..#........##...#.#.................
.#..#.##.#.#..#.......#..#.......#..........#..................#...............##....#..........###......#........##.#.......#...#.
..#.#....#.........#..#.#.#...#.......................#.#....##.....#.......................................#..#...#............##.
...#..#...........##........#...............##..#.......#......#.....#........###.#...............#............#.............##.##.
.....#..#..........#............#.................##...#................#...#..........#..................................#...#....
..#...................#.#.................................#.....#...............#.#...#..............##......#..#.........##.......
..#....#...........#..........#..........###...#...##..........#.....#.#..........##.....#.#........#..............................
..........##....#.#.........#..........#.....#...#.........#..........#...#.............#.###..........#..........#........#....#..
.....#...#....#..#..#........#.........................#...#............#.#.#.###..#...#..#...........#.#............#.......#.....
.....##....#..#....#.#....###.................##...........#...##........#.......###....##................#...#.#..#....##.......#.
.......#.##.........#...................#......................#.........#...#.............................#.###...............#...
....#..##...##...###......#............#.#........#.#....#..#.....#..##.........#.#............#...........#.#.....##..............
.............#.....#.....#...........#.#.........#......#.#..#.............#......#.##......#..#...............#...#..#.#...#.#.#..
......#...#....#....#.....................#.......#...#...........#...#......#..............##...#.................##.#..##...#....
..#....#.#........#..................#....##.....#......#.......#..#.............#....#...#...#.#................................#.
....#....#.#.....#.............#.........#.........#....#.#...#...#.................#...............#.......##.....................
.#....##..#..#.#.................#.........................##...........#....#.#..#...#.....#...#.....................#.....#......
.#....#..#.....#........................#.......#..#..#......#..#.#...#....#...###...#..........#.#...........#.....##.#...........
....##......##.....#.......##....#.#......##..#....#.........##.#.##....#........#............##...#.###......................#....
..#..............#...............#.....##........#....#.#.#........#........#........#.....##....#....##...........#.#.#...........
.#.......#...#.#.........#.#.......#.....#.#....#....#..............#.#.#..#.#..................#.......#...................#......
.............................##....#....#..#............##....#......#...#....................#..#.......#........#....#..#..#.....
..............#.................#...#.#....#..##.......#...........#...###........###....#......##......##.............#.......#...
.......##...#.................#..#...#.....###..#...#......#.......##....#..#.#..................#....#..........................#.
........#..#.........###......#.....#...#..#...#.......#....#..#...#...#......##....#.....#...#...#.#.#...#............#.#....#....
.....#................#....#........#.#...........##.......#.............#...........#........#.......#..#.........................
.#..................#....#.......#...#................#......#.............#.....#...#.....#...#....#..........#..........##...#...
..#...................#.....#.#..#.#..#.............#...................#...#...#..#.......#.#.....#.....................##........
.#.......#.........#...#..............#.#...#.................#.#..#.........##....#...#...#....##.....#.......##........##.....#..
........#.........#...#....#.#.#.....#...#........#..........#........................#......#...............#..............#.#....
...##.#.............#..#..##..#..........##.#..#......#.....#.....#...#.........##.#....#.....#..............#.##..........##......
.##.............#...#...#...#..........#...........##.......#.........#.#...#.............#...#.....##.....##.................#....
....#........#......#...#..#.#.............#..#.............#.....#.#.....#.......#.#.......#.......#.......#.....##.#.......#.....
.#..................#..#......#..##........#.......#..................##...#...............#..#...#.........#..#.#..##...........#.
...........#.#......#....#.#.....#......#........#....#...#.........#.#.#...#..........#...#..#...#..#......##...#.#...#.........#.
............#.#.#.....##..#.........#..#.#.........#.#...##..#..#.#...................#.##.........###..............#..............
......................#..#.........#........#.#..#.#.#.#.............#.........##.#..#....#......##........#.#..#..................
..........##................#......#......#....#..#..#.##...........#..........#.....#....#......#............#.........#..........
...........#..............#..................#..#.....#.#.#...###.#.....#.........#..............#......#.###...#..................
........#.#.####.........#........#.....#....#......#.#........#..........#.#........#.....##...##....#.##....##...#....#..........
.................#....#....#.....###..#...#.##....##......#.......#.......#...##.....###.............#.#...#.....#.................
.................................................................S.................................................................
.......#...............#..#..#.........##.............##......#.......##.#......#...#.###......#..#.............#....#....###......
........##.##.#..###......#...#.##....................#.......#....#....#......#........#...................#......................
.......#.......#...#....#.........#.##....#.....#...........#.......#....#...#..#.......#..#..#..#........##.........#...#.........
.........#..........##.#..#.#.#........................#..#.#.......##..#.....##...#.#.........##..................................
.#...........#.##.#.....#.........#............#....##..#...##.##...............#.#...#..#...#.###.##....#.........#...............
..................##...#.........#..........#..#.....#.#............#..##....##........#...#............#..##........#..#..........
.##............#.#...#......#.#..##.....................#..#.##......#.........#..........#............#...........##..............
....#........##...#...........#...........#...#............#..#.#............#...............##....##.........................#..#.
.#...................#....#.........#.#...#..........#..........#..#....#.........#...#.#..#....#................#...#..........#..
...................##...#.....#.....#...#.....#..#......#............####..............#.....#..#..#.#....#.....#..................
...#...#.............#...#.....#.#.......#.#...#.#........................#...#.....#...#..............#.......##............#.....
..#..#...........#.....##.....#............#...#.....#.#...#.......###.......#.#............#...................#..................
........#...........#..#......#..#....................#..#....#.........................#..........................................
........#.........#..#......#..#.#......#....#..#.........................#...#..#....#..#..#...#......#...#..#..............#.....
..........#.....................#....#...#...........#......#.........##.......#..............#.#.....#........#................#..
...#...#.............#...........#...#......##........#......#......##...#..........#.....##...#....#...##...............#.....#...
.....#..............................#.#...................##...#...#..##..#.................###..............#.........#......##.#.
....#.............................#.#.....#.....#...#........#..#.............#....#....###......##......#.....................#...
.#......#...................#..................#....#...........#........#..........###.....#.##...#....#..........##...........##.
.#.....##....................#...#..........#...#..#..#.........#..##...#....................#........#.............#.##...........
....#....#.......#...............................#.........#......#####......................#......#.............#.#..........#...
..#......#...................#..#........#..#.#...#..#.......................##..#.....##..............#..........#....#.#.......#.
............#...............#....##.#............#...##......#..........##..##...............#.........................#.........#.
...##......#...#..##............#.#...#....#...#.#.................#.#..#..#.###..#.....#...#.....#..#.............#............#..
..#.#..#...#.#..#.#..........#.##.#.......#......#......#....#.............#..................................#........#..#....#.#.
.....#...............##............#..#.##..#.#..#...........#..................................#.............#.....#.###....#.....
.....#.........................#...............#.............#....#.....##....#.#.........#.#..#............#......................
..#...#..#...........#..........#.#...#...#....#....................#...#......#.....#.#..#..#....#........#....................#..
....#..#....#.##.....#...........................##........###....#..#...................#...#.#...............#.#..........#......
...............#.#.#....................................#..#....#.....#..#...#.......#......#.............#..###..............#....
....#.#..#..#.......#...#..........#....##.....#..............###..........#...#.........................#....#............#.##....
.......###...##..........#..........#........#.#.#..#....#......#....#..#...#..........##................##............#...........
.....#..##..#............#.#.........#.#....#....#......#..#.##.....#..#.#...#.....#.................#...#..#..##..........##......
...........#.#..#....#..#.................#......#......###...............#.............#....................#..#.#.....##......#..
...........#..#.........##...............#.#.............#........#..#.........#..........#.............#.......#...........#.##...
.........#.#...........#................................................##........#.....#.............................#............
.#.#..#..#....##...#.......#..#..............##......#..............#..............#...#............#..#..#..#...........#.#....#..
...#.#...#.........#....#.....#...........###....#.#....#.........#.....##......#....#..............##....#...#...#..#.....#.......
..#..##.......#.........#....................#.#...............#...#....##...#.....#............................#..........#.#.....
....#....#...........#...#..#.......................##....#...#.....##..........#....##..............#..##...##....#.......#....#..
......#...#................#...#.##............................#..............................#.#....#............#.#..#.#..##.....
...............#.##..#.#.#....#....................#.........#.#..#.......#.................#....#.....#.................#...#.#...
..#....##.#......#..#......#..#................###.....#......#.#.....#...........#.........#.#...........#..#.......#..#.#........
.......#.......................#...........................#...................#..............#......##............#....#......#...
..#....#.#..#..#.#.....#...#..#..#.....#........................#....#.#.........#.........#....##..#............#..#......##......
.........#......##.#..........#..........#............#....#............#....#..........##.....#.#...#...#...##....##....#.......#.
...#..#.#..................##..#...#....#.#..........#......#.#.....#...................................###.........#........#.....
.................#......#...#..#........#............#......##.....#....###...........#..#.#.#..................#..#..#....#.....#.
...#..#..#..#........##..#...........................#......#.##..##....#.#..........#....#......#...#.......#....#....##..........
..#........##.#.....#..#.#.....#.....#...#..##.....................#....#..#..........#..#.#..#..#..##..........#.......#...#......
............#..#..#.#.....#.#......#...#.##...............#...#.......#.............#.....##.#....#.##.........#....##........#....
.##..#......##.................##.#.....#..................#......#..#.#.................##....#.#....#..............#.#.#..#......
....#....#...#..#..#...#...#.....#............#...........##...........#.........#......#...#.....#...#..#..##..#.#.#....#.........
..#....#.....#.....#.............#....#..#.#..#................#................#.............#......#...#.#.....#.......##..#.....
......#.................#...#..........#...#.....#.........#.#.....##.......................#....#....#..#..#.#........#..#........
......#....#....#.#......#............#...#...................................#.....#....#.......#.##....#...#..................#..
.....................#...........#....#..#..#....#...#.........#...............#..#.........#........#........#.#...#.#........#...
.##....#.#...#.....#........................#.............................................#...#.#...#.....##........#...#...#......
......#......#.....#.......#............#......................................#......#......#.#.##..........#.#..##.#......#......
.....#..#......#........#....#....#..........##......................................#...........#..........#..#.....###...#.#.....
....#...................##.........##..#....#.#.#..##.......................###....#.###.#.....#...#.#.......#.....#.#...#....#....
.##.........#.........#.#......#...##...................................#....##...#...#.......#....##......#..............#....#...
.............##......#.##.......##.....##...#..#.#...##......................#..#...#...........#...##........#........##.#........
..........#.......#..................###.##........#......#..........................#......#........#..#..............#...........
...................................................................................................................................