\|.....-.....\....../.....-....................................../....-.............|.......|....|...\........
...............|...|...........-............../......../..|.........|..../....-.-.|...........|..............|
.........|....\......-..............................|.....\..........\........../.../...../..\...........|....
...-................................................./.-...-..................../....../..|....|..............
\...|...|-.............................................................................-.................--|..
...............|.....|.......\..|.....-................................|.........../............/.........../.
.\....\............./............|...........\...|.....................\.-.\......-............|...........\..
./..........................\..\.........|.-...............................|........|..-....-............/....
............/....................-........../.....................................-.................|.........
..................................|/....-......................|............./...............\...............-
............|||.....\....|....|.........-................\..............\.................-...............\...
......-...........................-.......\.....................-..............-...|....\.....-...............
./............/.-|.\/.......-./\........\..\-.............../....-.....-........././...........|............\.
.-..-.............-\...............................|....\......||/.......|....../...|.................\.......
..|/..............................|.|............../........-..........\/......./.......--...........|........
...-/.....\........\...|.................................\.../.................\-......../...........\........
................-...|............/........./\\.................../......../|.........../.........|-..\........
............\............./\....................|//.......|-|...-/........\..............................-....
..................|...../..................\..|.........\.............|...................|........\...-...|..
........../................../............................./.........|.................\...............-\../..
.../...........\....|.................\.........................................../.......................//..
/..\..................................\....|.................|..-....|......................|.....|...........
.....-.......\.........-.-.....|.................\-.............|........./................/.\-.........|.....
.........-....-...................../..//...../....../..........|......./../.........--....-......\..../......
.....\\............................./.../....../...../......./.........../..-..........|-.....................
.............|.|........................../.......-......|..-..........|.............\..................../../
.../...../..\.........|.........................\.....\....-...........-.....\....................\...........
..................../........./.|....|............................../......-..../................./...|.......
..........................|....|...\.............\..................-.....\-..................................
......\...\......./..\.-.....-.......-...|...........-.........\.-....../...-.../................-............
.....................\.........................|.............................-...\............-.../...........
...../\...-../..|................/............../...........|/.-........-.................../.......-.....-...
...../.......|...............................................................................|....-......\....
-........................../....|.....\.................|......-/...................|...|/....................
..|...\...............-.............\.........../...../\.....|...........-..-.\....../....../...........|.....
....../...-..\...........\....../......|...\............../.................-...............|.\.-.............
../........|......../....../..|..........................\......-.............\.|.\...|/...../|...............
......|.......\-....\...|........-.........|.....|.....\--................-............\..................|...
|......../.......-.\....\...........|...................|......|...../...|..|........\....\....../............
......|..............-../..\..../................./.......\.......\...\......../...../........................
.-........................|.../...|...........|.......\...........|.\........................-............/...
............................../\..........-.|.//..............................|/.........\..................|.
.........................../................/......................../..........|...................\./.......
.....|....../...../............../.....-.|./\............|.....................|..............\...............
.....\|.........\./.../.......|.\................../..........-............/......\...................-...|/..
....--.........//.....-\........................\//.....-|......|./.............\...............|-.../......|.
.\....................................../..........-..\....\...\...|..................-.......................
../\............|....|\.|\................/............|.../...............................\......../.--......
....................-............/....|.|....||.....................|..........|./...\...--...../....\....|...
......-....|.................-.-.....|................|........../........\...|.............|/...........\....
....................-...-................-./|./.............................-.............../.................
........|.-.........../..../..||.......\........../................................/..........................
.........|..-....-..-......./......|\......................-..........-...\...|....\.../..|..\........./......
........................\............/...........\.-..........\.\..|\.../.....\...........|.....|..../....\...
.......-.\.......................-.../.........................\/........\.\..|...............................
................./..-.|................-..\.......|....................\.......................|.....-........
./.-.....................|............./........||-......|......-../............-.....-.......|...-.|........-
.........-.\../................/....--...-................-....-................/......./.....././-../\.......
...|......\./.......\|....\....\....\.........../.....|..........|...................|................\....../
...|............\-.........................-................................../.......\.-..........//.........
..\....../...........................-...-....-.......-...............|..................../........./......|.
.././............................/............|...............-........|...............|.........-......\./...
.......-.....\............|.........-\..............-\-............/..\.../\.|..|..../........................
............|..-....\................................-...|-..-/...................-......./\............./....
........\...................\.|...|......................|.........../...\-..\...\..........................\.
........\......-.....|...-............./.......-...............\...-..-..........-.-................-......\..
..|..........\..............-.-..............\........../................/....................................
.....................\................../.........../..-...................-...\...................|.\..-.....
...........|.................|../....\........|...\-./...............|...........\...........\..............-.
...................................................................\............|..........................-..
............|..............\....|................|............-.....|....|.................\.........|..|.....
........................|......\..............-.../............-.|/.-........................\................
.......................|......../....../........-............-......./....................|....../............
.........-............\...........|....................\.......\.................\.\...../../-..............-.
.\.......\....-/...............-.......................-............................|.|......\....-.......\|..
....\..\..........................\/.\...|.............-.|..................../.......-.\/....|..............\
........................../.........|..-\...-......-....\.../.........-.../....-.......|...-............\.-...
.....\.........\......|........../.../.............|.....\../..|...........\.......................-......\...
|.........|....|../....\..................................\...../.........\............................\.\.../
-...../...\.............-...//...............\........\...|.-.....................\....|.....\...--...........
....|...-..-...|\.....-\..........|..............|........................-/.....-............./..............
.-.........................\../.......|............|..|.|..|.|....../.....|-../\.............\.../.\......\...
................\.........|...\...|....|..........|..........\................................-...............
.........../-\.....-/.....|.\./........-................/.-.....\...........\..........\......................
../..|\...|./............................../.|.......|....\...............|.................\................-
...-...............|.....|...-.........-.|........\.....-...........\...............-......-.|.\..............
................/.-.-.........................\.-..|.\................................................|....../
....................-..|...........|.......|.........-.\....................................-....../....-.....
.....................-..........................-.............................\.\....|...-...\...|..|.........
./\........-..................................|................|..........................|...\|......\.......
...\.......-..........-......................|...........................-...|................................
..................................././.....|....|........\|.....|..-...............\\.................-.......
.-.....././.......|...................-...................-................................................../
..-..|......../.....|...................\..../....................................|..\...-\................/..
..................|.........................../......\..-....\............|-/..-................\|../...\...-.
............../-..-..../............................../........|.......................................\./.|..
....\......\....|....................-....|........................-\...|........\......................\.....
.........|...........|.............................-..................\.\............/.../....................
.|..-.......................|...............|..-............../.\................./.....\......-..|...........
..-.../.......................................-/.........|........-.............-......\........./...\../.....
......................\/...............|................\../............-.........|......\....................
...........-|.................../...../\..../........|.....-............................/-.|..\\.../..........
.........\.......|......../......./.......\..|.....-..............|................................|..........
....................................|........|/.......-.......|.........|//...................................
...........|......\...../../....................\..\......................./..........-......-.....|..........
../................./..-.........................-..........\-|......./.....-.\.........\.....................
..............................\.......|....\.....................................................-....\....|..
.........-\...............\...../\......-.....\................./........................-....\...............
.|............................................-..../../\......................................./....\........\
-........-...........|............./..........-...............................-.......-..../..................